0011100000
0E00100000
0000100000
E011E00000
0030000000
0011100040
E000000000